"filename", "language", "Python", "Markdown", "Batch", "comment", "blank", "total"
"d:\_code\py\artegame\README.md", "Markdown", 0, 23, 0, 0, 14, 37
"d:\_code\py\artegame\architect.bat", "Batch", 0, 0, 1, 0, 0, 1
"d:\_code\py\artegame\architect\__config__.py", "Python", 29, 0, 0, 6, 10, 45
"d:\_code\py\artegame\architect\__main__.py", "Python", 19, 0, 0, 0, 8, 27
"d:\_code\py\artegame\architect\b64encoder.py", "Python", 36, 0, 0, 3, 14, 53
"d:\_code\py\artegame\architect\cli.py", "Python", 161, 0, 0, 20, 59, 240
"d:\_code\py\artegame\architect\deps.py", "Python", 124, 0, 0, 10, 48, 182
"d:\_code\py\artegame\architect\import_generator.py", "Python", 228, 0, 0, 8, 68, 304
"d:\_code\py\artegame\brass\__main__.py", "Python", 66, 0, 0, 11, 22, 99
"d:\_code\py\artegame\brass\animator\__init__.py", "Python", 134, 0, 0, 48, 63, 245
"d:\_code\py\artegame\brass\animator\interpolation.py", "Python", 51, 0, 0, 2, 15, 68
"d:\_code\py\artegame\brass\animator\play_objects.py", "Python", 25, 0, 0, 0, 13, 38
"d:\_code\py\artegame\brass\animator\store.py", "Python", 11, 0, 0, 0, 7, 18
"d:\_code\py\artegame\brass\assets.py", "Python", 49, 0, 0, 4, 21, 74
"d:\_code\py\artegame\brass\audio.py", "Python", 37, 0, 0, 1, 25, 63
"d:\_code\py\artegame\brass\base.py", "Python", 101, 0, 0, 1, 42, 144
"d:\_code\py\artegame\brass\collision.py", "Python", 128, 0, 0, 3, 33, 164
"d:\_code\py\artegame\brass\display.py", "Python", 240, 0, 0, 33, 70, 343
"d:\_code\py\artegame\brass\enums\__init__.py", "Python", 8, 0, 0, 1, 1, 10
"d:\_code\py\artegame\brass\enums\animations.py", "Python", 9, 0, 0, 0, 5, 14
"d:\_code\py\artegame\brass\enums\gui.py", "Python", 25, 0, 0, 0, 8, 33
"d:\_code\py\artegame\brass\enums\input_modes.py", "Python", 2, 0, 0, 0, 2, 4
"d:\_code\py\artegame\brass\enums\keybinds.py", "Python", 11, 0, 0, 0, 6, 17
"d:\_code\py\artegame\brass\enums\scenes.py", "Python", 2, 0, 0, 1, 2, 5
"d:\_code\py\artegame\brass\enums\spells.py", "Python", 33, 0, 0, 0, 4, 37
"d:\_code\py\artegame\brass\events.py", "Python", 30, 0, 0, 0, 20, 50
"d:\_code\py\artegame\brass\gui.py", "Python", 229, 0, 0, 3, 58, 290
"d:\_code\py\artegame\brass\inpt.py", "Python", 296, 0, 0, 15, 99, 410
"d:\_code\py\artegame\brass\items.py", "Python", 80, 0, 0, 11, 40, 131
"d:\_code\py\artegame\brass\pgapi.py", "Python", 82, 0, 0, 0, 48, 130
"d:\_code\py\artegame\brass\saves.py", "Python", 69, 0, 0, 8, 32, 109
"d:\_code\py\artegame\brass\scene.py", "Python", 45, 0, 0, 6, 31, 82
"d:\_code\py\artegame\brass\structures.py", "Python", 303, 0, 0, 27, 104, 434
"d:\_code\py\artegame\brass\timeout.py", "Python", 14, 0, 0, 0, 8, 22
"d:\_code\py\artegame\brass\vectormath.py", "Python", 214, 0, 0, 4, 71, 289
"d:\_code\py\artegame\src\global_routines\crowd_control.py", "Python", 62, 0, 0, 3, 20, 85
"d:\_code\py\artegame\src\global_routines\dash.py", "Python", 32, 0, 0, 2, 14, 48
"d:\_code\py\artegame\src\global_routines\effect_display.py", "Python", 30, 0, 0, 3, 13, 46
"d:\_code\py\artegame\src\global_routines\enemies.py", "Python", 140, 0, 0, 5, 31, 176
"d:\_code\py\artegame\src\global_routines\menu.py", "Python", 25, 0, 0, 0, 13, 38
"d:\_code\py\artegame\src\global_routines\projectiles.py", "Python", 151, 0, 0, 10, 24, 185
"d:\_code\py\artegame\src\global_routines\sounds.py", "Python", 22, 0, 0, 0, 16, 38
"d:\_code\py\artegame\src\global_routines\spells.py", "Python", 90, 0, 0, 0, 41, 131
"d:\_code\py\artegame\src\scenes\default\routines\conf.py", "Python", 9, 0, 0, 5, 4, 18
"d:\_code\py\artegame\src\scenes\default\routines\main.py", "Python", 13, 0, 0, 6, 6, 25
"d:\_code\py\artegame\src\scenes\default\ui\index.py", "Python", 92, 0, 0, 10, 14, 116
"d:\_code\py\artegame\src\scenes\game\routines\conf.py", "Python", 178, 0, 0, 101, 13, 292
"d:\_code\py\artegame\src\scenes\game\routines\main.py", "Python", 72, 0, 0, 8, 11, 91
"d:\_code\py\artegame\src\scenes\game\routines\player.py", "Python", 327, 0, 0, 29, 89, 445
"d:\_code\py\artegame\src\scenes\game\ui\index.py", "Python", 195, 0, 0, 1, 12, 208
"Total", "-", 4329, 23, 1, 409, 1392, 6154