"filename", "language", "Python", "Markdown", "TOML", "Ini", "comment", "blank", "total"
"/Users/zoltantakacs/_code/py/artegame/.pylintrc", "Ini", 0, 0, 0, 29, 0, 5, 34
"/Users/zoltantakacs/_code/py/artegame/README.md", "Markdown", 0, 53, 0, 0, 0, 10, 63
"/Users/zoltantakacs/_code/py/artegame/architect/__config__.py", "Python", 34, 0, 0, 0, 6, 12, 52
"/Users/zoltantakacs/_code/py/artegame/architect/__main__.py", "Python", 23, 0, 0, 0, 0, 9, 32
"/Users/zoltantakacs/_code/py/artegame/architect/b64encoder.py", "Python", 36, 0, 0, 0, 3, 18, 57
"/Users/zoltantakacs/_code/py/artegame/architect/cli.py", "Python", 178, 0, 0, 0, 19, 63, 260
"/Users/zoltantakacs/_code/py/artegame/architect/deps.py", "Python", 158, 0, 0, 0, 11, 62, 231
"/Users/zoltantakacs/_code/py/artegame/architect/import_generator.py", "Python", 286, 0, 0, 0, 19, 79, 384
"/Users/zoltantakacs/_code/py/artegame/brass/__init__.py", "Python", 74, 0, 0, 0, 22, 19, 115
"/Users/zoltantakacs/_code/py/artegame/brass/animator/__init__.py", "Python", 138, 0, 0, 0, 48, 65, 251
"/Users/zoltantakacs/_code/py/artegame/brass/animator/interpolation.py", "Python", 51, 0, 0, 0, 2, 16, 69
"/Users/zoltantakacs/_code/py/artegame/brass/animator/play_objects.py", "Python", 25, 0, 0, 0, 0, 11, 36
"/Users/zoltantakacs/_code/py/artegame/brass/animator/store.py", "Python", 9, 0, 0, 0, 0, 6, 15
"/Users/zoltantakacs/_code/py/artegame/brass/assets.py", "Python", 50, 0, 0, 0, 18, 28, 96
"/Users/zoltantakacs/_code/py/artegame/brass/audio.py", "Python", 41, 0, 0, 0, 1, 28, 70
"/Users/zoltantakacs/_code/py/artegame/brass/base.py", "Python", 115, 0, 0, 0, 1, 55, 171
"/Users/zoltantakacs/_code/py/artegame/brass/collision.py", "Python", 127, 0, 0, 0, 3, 34, 164
"/Users/zoltantakacs/_code/py/artegame/brass/display.py", "Python", 243, 0, 0, 0, 35, 69, 347
"/Users/zoltantakacs/_code/py/artegame/brass/enums/__init__.py", "Python", 7, 0, 0, 0, 1, 1, 9
"/Users/zoltantakacs/_code/py/artegame/brass/enums/animations.py", "Python", 9, 0, 0, 0, 0, 5, 14
"/Users/zoltantakacs/_code/py/artegame/brass/enums/base_keybinds.py", "Python", 3, 0, 0, 0, 0, 1, 4
"/Users/zoltantakacs/_code/py/artegame/brass/enums/gui.py", "Python", 30, 0, 0, 0, 0, 8, 38
"/Users/zoltantakacs/_code/py/artegame/brass/enums/input_modes.py", "Python", 2, 0, 0, 0, 0, 2, 4
"/Users/zoltantakacs/_code/py/artegame/brass/enums/scenes.py", "Python", 3, 0, 0, 0, 1, 2, 6
"/Users/zoltantakacs/_code/py/artegame/brass/events.py", "Python", 30, 0, 0, 0, 0, 20, 50
"/Users/zoltantakacs/_code/py/artegame/brass/gui.py", "Python", 252, 0, 0, 0, 8, 70, 330
"/Users/zoltantakacs/_code/py/artegame/brass/inpt.py", "Python", 296, 0, 0, 0, 21, 106, 423
"/Users/zoltantakacs/_code/py/artegame/brass/items.py", "Python", 86, 0, 0, 0, 10, 46, 142
"/Users/zoltantakacs/_code/py/artegame/brass/pgapi.py", "Python", 77, 0, 0, 0, 0, 46, 123
"/Users/zoltantakacs/_code/py/artegame/brass/saves.py", "Python", 68, 0, 0, 0, 17, 35, 120
"/Users/zoltantakacs/_code/py/artegame/brass/scene.py", "Python", 47, 0, 0, 0, 6, 30, 83
"/Users/zoltantakacs/_code/py/artegame/brass/structures.py", "Python", 331, 0, 0, 0, 30, 112, 473
"/Users/zoltantakacs/_code/py/artegame/brass/timeout.py", "Python", 16, 0, 0, 0, 2, 8, 26
"/Users/zoltantakacs/_code/py/artegame/brass/vectormath.py", "Python", 214, 0, 0, 0, 4, 72, 290
"/Users/zoltantakacs/_code/py/artegame/pyproject.toml", "TOML", 0, 0, 9, 0, 0, 1, 10
"/Users/zoltantakacs/_code/py/artegame/src/__init__.py", "Python", 4, 0, 0, 0, 0, 1, 5
"/Users/zoltantakacs/_code/py/artegame/src/enums/__init__.py", "Python", 4, 0, 0, 0, 0, 1, 5
"/Users/zoltantakacs/_code/py/artegame/src/enums/keybinds.py", "Python", 9, 0, 0, 0, 0, 6, 15
"/Users/zoltantakacs/_code/py/artegame/src/enums/spell_enum.py", "Python", 37, 0, 0, 0, 0, 4, 41
"/Users/zoltantakacs/_code/py/artegame/src/global_routines/__init__.py", "Python", 13, 0, 0, 0, 0, 1, 14
"/Users/zoltantakacs/_code/py/artegame/src/global_routines/boons.py", "Python", 797, 0, 0, 0, 106, 202, 1105
"/Users/zoltantakacs/_code/py/artegame/src/global_routines/crowd_control.py", "Python", 70, 0, 0, 0, 3, 20, 93
"/Users/zoltantakacs/_code/py/artegame/src/global_routines/dash.py", "Python", 31, 0, 0, 0, 2, 13, 46
"/Users/zoltantakacs/_code/py/artegame/src/global_routines/effect_display.py", "Python", 30, 0, 0, 0, 3, 13, 46
"/Users/zoltantakacs/_code/py/artegame/src/global_routines/enemies.py", "Python", 214, 0, 0, 0, 11, 46, 271
"/Users/zoltantakacs/_code/py/artegame/src/global_routines/interact.py", "Python", 40, 0, 0, 0, 0, 26, 66
"/Users/zoltantakacs/_code/py/artegame/src/global_routines/menus.py", "Python", 57, 0, 0, 0, 2, 27, 86
"/Users/zoltantakacs/_code/py/artegame/src/global_routines/projectiles.py", "Python", 160, 0, 0, 0, 10, 26, 196
"/Users/zoltantakacs/_code/py/artegame/src/global_routines/round_manager.py", "Python", 133, 0, 0, 0, 2, 33, 168
"/Users/zoltantakacs/_code/py/artegame/src/global_routines/sounds.py", "Python", 36, 0, 0, 0, 0, 19, 55
"/Users/zoltantakacs/_code/py/artegame/src/global_routines/spells.py", "Python", 121, 0, 0, 0, 1, 47, 169
"/Users/zoltantakacs/_code/py/artegame/src/scenes/default/routines/conf.py", "Python", 9, 0, 0, 0, 5, 4, 18
"/Users/zoltantakacs/_code/py/artegame/src/scenes/default/routines/main.py", "Python", 13, 0, 0, 0, 6, 6, 25
"/Users/zoltantakacs/_code/py/artegame/src/scenes/default/ui/index.py", "Python", 84, 0, 0, 0, 12, 14, 110
"/Users/zoltantakacs/_code/py/artegame/src/scenes/defeat/routines/conf.py", "Python", 9, 0, 0, 0, 5, 4, 18
"/Users/zoltantakacs/_code/py/artegame/src/scenes/defeat/routines/main.py", "Python", 13, 0, 0, 0, 6, 6, 25
"/Users/zoltantakacs/_code/py/artegame/src/scenes/defeat/ui/index.py", "Python", 106, 0, 0, 0, 10, 14, 130
"/Users/zoltantakacs/_code/py/artegame/src/scenes/game/routines/conf.py", "Python", 298, 0, 0, 0, 109, 13, 420
"/Users/zoltantakacs/_code/py/artegame/src/scenes/game/routines/main.py", "Python", 24, 0, 0, 0, 7, 7, 38
"/Users/zoltantakacs/_code/py/artegame/src/scenes/game/routines/player.py", "Python", 472, 0, 0, 0, 51, 129, 652
"/Users/zoltantakacs/_code/py/artegame/src/scenes/game/ui/index.py", "Python", 503, 0, 0, 0, 29, 15, 547
"Total", "-", 6346, 53, 9, 29, 668, 1851, 8956