"filename", "language", "Python", "comment", "blank", "total"
"d:\_code\py\artegame\brass\__main__.py", "Python", 1, -1, 0, 0
"d:\_code\py\artegame\brass\base.py", "Python", 16, 0, 12, 28
"d:\_code\py\artegame\brass\enums\gui.py", "Python", 2, 0, 0, 2
"d:\_code\py\artegame\brass\enums\keybinds.py", "Python", 1, 0, 0, 1
"d:\_code\py\artegame\brass\gui.py", "Python", 17, 4, 10, 31
"d:\_code\py\artegame\brass\inpt.py", "Python", -1, 1, 0, 0
"d:\_code\py\artegame\brass\structures.py", "Python", 25, 3, 8, 36
"d:\_code\py\artegame\src\global_routines\boons.py", "Python", 813, 106, 209, 1128
"d:\_code\py\artegame\src\global_routines\interact.py", "Python", 32, 0, 19, 51
"d:\_code\py\artegame\src\global_routines\menu.py", "Python", -25, 0, -13, -38
"d:\_code\py\artegame\src\global_routines\menus.py", "Python", 58, 2, 27, 87
"d:\_code\py\artegame\src\global_routines\round_manager.py", "Python", 82, 2, 23, 107
"d:\_code\py\artegame\src\scenes\game\routines\conf.py", "Python", 76, 9, 0, 85
"d:\_code\py\artegame\src\scenes\game\routines\main.py", "Python", -2, -1, -2, -5
"d:\_code\py\artegame\src\scenes\game\routines\player.py", "Python", 16, -1, 5, 20
"d:\_code\py\artegame\src\scenes\game\ui\index.py", "Python", 185, 24, 1, 210
"Total", "-", 1296, 148, 299, 1743