"filename", "language", "Python", "Ini", "Markdown", "TOML", "JSON", "comment", "blank", "total"
"/Users/zoltantakacs/Projects/artegame/.pylintrc", "Ini", 0, 30, 0, 0, 0, 0, 7, 37
"/Users/zoltantakacs/Projects/artegame/README.md", "Markdown", 0, 0, 53, 0, 0, 0, 10, 63
"/Users/zoltantakacs/Projects/artegame/architect/__config__.py", "Python", 33, 0, 0, 0, 0, 6, 13, 52
"/Users/zoltantakacs/Projects/artegame/architect/__main__.py", "Python", 24, 0, 0, 0, 0, 0, 9, 33
"/Users/zoltantakacs/Projects/artegame/architect/b64encoder.py", "Python", 35, 0, 0, 0, 0, 6, 19, 60
"/Users/zoltantakacs/Projects/artegame/architect/cli.py", "Python", 195, 0, 0, 0, 0, 19, 67, 281
"/Users/zoltantakacs/Projects/artegame/architect/deps.py", "Python", 159, 0, 0, 0, 0, 11, 62, 232
"/Users/zoltantakacs/Projects/artegame/architect/import_generator.py", "Python", 277, 0, 0, 0, 0, 16, 82, 375
"/Users/zoltantakacs/Projects/artegame/brass/__init__.py", "Python", 87, 0, 0, 0, 0, 7, 22, 116
"/Users/zoltantakacs/Projects/artegame/brass/animator/__init__.py", "Python", 138, 0, 0, 0, 0, 48, 65, 251
"/Users/zoltantakacs/Projects/artegame/brass/animator/interpolation.py", "Python", 41, 0, 0, 0, 0, 12, 16, 69
"/Users/zoltantakacs/Projects/artegame/brass/animator/play_objects.py", "Python", 25, 0, 0, 0, 0, 0, 11, 36
"/Users/zoltantakacs/Projects/artegame/brass/animator/store.py", "Python", 9, 0, 0, 0, 0, 0, 6, 15
"/Users/zoltantakacs/Projects/artegame/brass/assets.py", "Python", 50, 0, 0, 0, 0, 18, 28, 96
"/Users/zoltantakacs/Projects/artegame/brass/audio.py", "Python", 41, 0, 0, 0, 0, 1, 28, 70
"/Users/zoltantakacs/Projects/artegame/brass/base.py", "Python", 103, 0, 0, 0, 0, 3, 53, 159
"/Users/zoltantakacs/Projects/artegame/brass/collision.py", "Python", 127, 0, 0, 0, 0, 3, 34, 164
"/Users/zoltantakacs/Projects/artegame/brass/display.py", "Python", 243, 0, 0, 0, 0, 35, 69, 347
"/Users/zoltantakacs/Projects/artegame/brass/enums/__init__.py", "Python", 7, 0, 0, 0, 0, 1, 1, 9
"/Users/zoltantakacs/Projects/artegame/brass/enums/animations.py", "Python", 10, 0, 0, 0, 0, 0, 5, 15
"/Users/zoltantakacs/Projects/artegame/brass/enums/base_keybinds.py", "Python", 3, 0, 0, 0, 0, 0, 1, 4
"/Users/zoltantakacs/Projects/artegame/brass/enums/gui.py", "Python", 30, 0, 0, 0, 0, 0, 8, 38
"/Users/zoltantakacs/Projects/artegame/brass/enums/input_modes.py", "Python", 2, 0, 0, 0, 0, 0, 2, 4
"/Users/zoltantakacs/Projects/artegame/brass/enums/scenes.py", "Python", 3, 0, 0, 0, 0, 1, 2, 6
"/Users/zoltantakacs/Projects/artegame/brass/events.py", "Python", 30, 0, 0, 0, 0, 0, 20, 50
"/Users/zoltantakacs/Projects/artegame/brass/gui.py", "Python", 238, 0, 0, 0, 0, 23, 69, 330
"/Users/zoltantakacs/Projects/artegame/brass/inpt.py", "Python", 249, 0, 0, 0, 0, 80, 94, 423
"/Users/zoltantakacs/Projects/artegame/brass/items.py", "Python", 61, 0, 0, 0, 0, 42, 39, 142
"/Users/zoltantakacs/Projects/artegame/brass/pgapi.py", "Python", 86, 0, 0, 0, 0, 0, 49, 135
"/Users/zoltantakacs/Projects/artegame/brass/saves.py", "Python", 68, 0, 0, 0, 0, 17, 35, 120
"/Users/zoltantakacs/Projects/artegame/brass/scene.py", "Python", 47, 0, 0, 0, 0, 6, 30, 83
"/Users/zoltantakacs/Projects/artegame/brass/structures.py", "Python", 302, 0, 0, 0, 0, 59, 112, 473
"/Users/zoltantakacs/Projects/artegame/brass/timeout.py", "Python", 16, 0, 0, 0, 0, 2, 8, 26
"/Users/zoltantakacs/Projects/artegame/brass/vectormath.py", "Python", 148, 0, 0, 0, 0, 88, 54, 290
"/Users/zoltantakacs/Projects/artegame/pyproject.toml", "TOML", 0, 0, 0, 10, 0, 0, 2, 12
"/Users/zoltantakacs/Projects/artegame/pyrightconfig.json", "JSON", 0, 0, 0, 0, 4, 0, 1, 5
"/Users/zoltantakacs/Projects/artegame/src/__init__.py", "Python", 4, 0, 0, 0, 0, 0, 1, 5
"/Users/zoltantakacs/Projects/artegame/src/enums/__init__.py", "Python", 4, 0, 0, 0, 0, 0, 1, 5
"/Users/zoltantakacs/Projects/artegame/src/enums/keybinds.py", "Python", 9, 0, 0, 0, 0, 0, 6, 15
"/Users/zoltantakacs/Projects/artegame/src/enums/spell_enum.py", "Python", 37, 0, 0, 0, 0, 0, 4, 41
"/Users/zoltantakacs/Projects/artegame/src/global_routines/__init__.py", "Python", 13, 0, 0, 0, 0, 0, 1, 14
"/Users/zoltantakacs/Projects/artegame/src/global_routines/boons.py", "Python", 797, 0, 0, 0, 0, 106, 202, 1105
"/Users/zoltantakacs/Projects/artegame/src/global_routines/crowd_control.py", "Python", 72, 0, 0, 0, 0, 0, 21, 93
"/Users/zoltantakacs/Projects/artegame/src/global_routines/dash.py", "Python", 37, 0, 0, 0, 0, 2, 14, 53
"/Users/zoltantakacs/Projects/artegame/src/global_routines/effect_display.py", "Python", 30, 0, 0, 0, 0, 3, 13, 46
"/Users/zoltantakacs/Projects/artegame/src/global_routines/enemies.py", "Python", 234, 0, 0, 0, 0, 7, 51, 292
"/Users/zoltantakacs/Projects/artegame/src/global_routines/interact.py", "Python", 40, 0, 0, 0, 0, 0, 25, 65
"/Users/zoltantakacs/Projects/artegame/src/global_routines/menus.py", "Python", 57, 0, 0, 0, 0, 2, 27, 86
"/Users/zoltantakacs/Projects/artegame/src/global_routines/projectiles.py", "Python", 160, 0, 0, 0, 0, 10, 26, 196
"/Users/zoltantakacs/Projects/artegame/src/global_routines/round_manager.py", "Python", 135, 0, 0, 0, 0, 2, 34, 171
"/Users/zoltantakacs/Projects/artegame/src/global_routines/sounds.py", "Python", 65, 0, 0, 0, 0, 0, 33, 98
"/Users/zoltantakacs/Projects/artegame/src/global_routines/spells.py", "Python", 121, 0, 0, 0, 0, 1, 47, 169
"/Users/zoltantakacs/Projects/artegame/src/scenes/default/routines/conf.py", "Python", 9, 0, 0, 0, 0, 5, 4, 18
"/Users/zoltantakacs/Projects/artegame/src/scenes/default/routines/main.py", "Python", 13, 0, 0, 0, 0, 6, 6, 25
"/Users/zoltantakacs/Projects/artegame/src/scenes/default/ui/index.py", "Python", 90, 0, 0, 0, 0, 11, 14, 115
"/Users/zoltantakacs/Projects/artegame/src/scenes/defeat/routines/conf.py", "Python", 9, 0, 0, 0, 0, 5, 4, 18
"/Users/zoltantakacs/Projects/artegame/src/scenes/defeat/routines/main.py", "Python", 13, 0, 0, 0, 0, 6, 6, 25
"/Users/zoltantakacs/Projects/artegame/src/scenes/defeat/ui/index.py", "Python", 106, 0, 0, 0, 0, 7, 14, 127
"/Users/zoltantakacs/Projects/artegame/src/scenes/game/routines/conf.py", "Python", 298, 0, 0, 0, 0, 109, 13, 420
"/Users/zoltantakacs/Projects/artegame/src/scenes/game/routines/main.py", "Python", 23, 0, 0, 0, 0, 7, 6, 36
"/Users/zoltantakacs/Projects/artegame/src/scenes/game/routines/player.py", "Python", 460, 0, 0, 0, 0, 51, 128, 639
"/Users/zoltantakacs/Projects/artegame/src/scenes/game/ui/index.py", "Python", 503, 0, 0, 0, 0, 29, 15, 547
"Total", "-", 6226, 30, 53, 10, 4, 873, 1849, 9045