"filename", "language", "Python", "Markdown", "Batch", "Ini", "comment", "blank", "total"
"d:\_code\python\24 - Summer\artegame\.pylintrc", "Ini", 0, 0, 0, 29, 0, 5, 34
"d:\_code\python\24 - Summer\artegame\README.md", "Markdown", 0, 23, 0, 0, 0, 14, 37
"d:\_code\python\24 - Summer\artegame\architect.bat", "Batch", 0, 0, 1, 0, 0, 0, 1
"d:\_code\python\24 - Summer\artegame\architect\__config__.py", "Python", 34, 0, 0, 0, 6, 12, 52
"d:\_code\python\24 - Summer\artegame\architect\__main__.py", "Python", 19, 0, 0, 0, 2, 8, 29
"d:\_code\python\24 - Summer\artegame\architect\b64encoder.py", "Python", 34, 0, 0, 0, 3, 17, 54
"d:\_code\python\24 - Summer\artegame\architect\cli.py", "Python", 176, 0, 0, 0, 19, 63, 258
"d:\_code\python\24 - Summer\artegame\architect\deps.py", "Python", 154, 0, 0, 0, 11, 59, 224
"d:\_code\python\24 - Summer\artegame\architect\import_generator.py", "Python", 285, 0, 0, 0, 25, 82, 392
"d:\_code\python\24 - Summer\artegame\brass\__init__.py", "Python", 72, 0, 0, 0, 21, 18, 111
"d:\_code\python\24 - Summer\artegame\brass\animator\__init__.py", "Python", 138, 0, 0, 0, 48, 65, 251
"d:\_code\python\24 - Summer\artegame\brass\animator\interpolation.py", "Python", 51, 0, 0, 0, 2, 16, 69
"d:\_code\python\24 - Summer\artegame\brass\animator\play_objects.py", "Python", 25, 0, 0, 0, 0, 11, 36
"d:\_code\python\24 - Summer\artegame\brass\animator\store.py", "Python", 9, 0, 0, 0, 0, 6, 15
"d:\_code\python\24 - Summer\artegame\brass\assets.py", "Python", 50, 0, 0, 0, 18, 28, 96
"d:\_code\python\24 - Summer\artegame\brass\audio.py", "Python", 41, 0, 0, 0, 1, 28, 70
"d:\_code\python\24 - Summer\artegame\brass\base.py", "Python", 115, 0, 0, 0, 1, 55, 171
"d:\_code\python\24 - Summer\artegame\brass\collision.py", "Python", 127, 0, 0, 0, 3, 34, 164
"d:\_code\python\24 - Summer\artegame\brass\display.py", "Python", 241, 0, 0, 0, 35, 68, 344
"d:\_code\python\24 - Summer\artegame\brass\enums\__init__.py", "Python", 7, 0, 0, 0, 1, 1, 9
"d:\_code\python\24 - Summer\artegame\brass\enums\animations.py", "Python", 9, 0, 0, 0, 0, 5, 14
"d:\_code\python\24 - Summer\artegame\brass\enums\base_keybinds.py", "Python", 3, 0, 0, 0, 0, 1, 4
"d:\_code\python\24 - Summer\artegame\brass\enums\gui.py", "Python", 30, 0, 0, 0, 0, 8, 38
"d:\_code\python\24 - Summer\artegame\brass\enums\input_modes.py", "Python", 2, 0, 0, 0, 0, 2, 4
"d:\_code\python\24 - Summer\artegame\brass\enums\scenes.py", "Python", 3, 0, 0, 0, 1, 2, 6
"d:\_code\python\24 - Summer\artegame\brass\events.py", "Python", 30, 0, 0, 0, 0, 20, 50
"d:\_code\python\24 - Summer\artegame\brass\gui.py", "Python", 252, 0, 0, 0, 8, 70, 330
"d:\_code\python\24 - Summer\artegame\brass\inpt.py", "Python", 296, 0, 0, 0, 21, 106, 423
"d:\_code\python\24 - Summer\artegame\brass\items.py", "Python", 86, 0, 0, 0, 10, 46, 142
"d:\_code\python\24 - Summer\artegame\brass\pgapi.py", "Python", 77, 0, 0, 0, 0, 46, 123
"d:\_code\python\24 - Summer\artegame\brass\saves.py", "Python", 83, 0, 0, 0, 13, 38, 134
"d:\_code\python\24 - Summer\artegame\brass\scene.py", "Python", 47, 0, 0, 0, 6, 30, 83
"d:\_code\python\24 - Summer\artegame\brass\structures.py", "Python", 330, 0, 0, 0, 30, 112, 472
"d:\_code\python\24 - Summer\artegame\brass\timeout.py", "Python", 16, 0, 0, 0, 2, 8, 26
"d:\_code\python\24 - Summer\artegame\brass\vectormath.py", "Python", 214, 0, 0, 0, 4, 72, 290
"d:\_code\python\24 - Summer\artegame\src\__init__.py", "Python", 4, 0, 0, 0, 0, 1, 5
"d:\_code\python\24 - Summer\artegame\src\enums\__init__.py", "Python", 4, 0, 0, 0, 0, 1, 5
"d:\_code\python\24 - Summer\artegame\src\enums\keybinds.py", "Python", 9, 0, 0, 0, 0, 6, 15
"d:\_code\python\24 - Summer\artegame\src\enums\spell_enum.py", "Python", 37, 0, 0, 0, 0, 4, 41
"d:\_code\python\24 - Summer\artegame\src\global_routines\__init__.py", "Python", 13, 0, 0, 0, 0, 1, 14
"d:\_code\python\24 - Summer\artegame\src\global_routines\boons.py", "Python", 797, 0, 0, 0, 106, 202, 1105
"d:\_code\python\24 - Summer\artegame\src\global_routines\crowd_control.py", "Python", 70, 0, 0, 0, 3, 20, 93
"d:\_code\python\24 - Summer\artegame\src\global_routines\dash.py", "Python", 31, 0, 0, 0, 2, 13, 46
"d:\_code\python\24 - Summer\artegame\src\global_routines\effect_display.py", "Python", 30, 0, 0, 0, 3, 13, 46
"d:\_code\python\24 - Summer\artegame\src\global_routines\enemies.py", "Python", 214, 0, 0, 0, 11, 46, 271
"d:\_code\python\24 - Summer\artegame\src\global_routines\interact.py", "Python", 40, 0, 0, 0, 0, 26, 66
"d:\_code\python\24 - Summer\artegame\src\global_routines\menus.py", "Python", 57, 0, 0, 0, 2, 27, 86
"d:\_code\python\24 - Summer\artegame\src\global_routines\projectiles.py", "Python", 160, 0, 0, 0, 10, 26, 196
"d:\_code\python\24 - Summer\artegame\src\global_routines\round_manager.py", "Python", 131, 0, 0, 0, 2, 33, 166
"d:\_code\python\24 - Summer\artegame\src\global_routines\sounds.py", "Python", 36, 0, 0, 0, 0, 19, 55
"d:\_code\python\24 - Summer\artegame\src\global_routines\spells.py", "Python", 121, 0, 0, 0, 1, 47, 169
"d:\_code\python\24 - Summer\artegame\src\scenes\default\routines\conf.py", "Python", 9, 0, 0, 0, 5, 4, 18
"d:\_code\python\24 - Summer\artegame\src\scenes\default\routines\main.py", "Python", 13, 0, 0, 0, 6, 6, 25
"d:\_code\python\24 - Summer\artegame\src\scenes\default\ui\index.py", "Python", 91, 0, 0, 0, 11, 14, 116
"d:\_code\python\24 - Summer\artegame\src\scenes\defeat\routines\conf.py", "Python", 9, 0, 0, 0, 5, 4, 18
"d:\_code\python\24 - Summer\artegame\src\scenes\defeat\routines\main.py", "Python", 13, 0, 0, 0, 6, 6, 25
"d:\_code\python\24 - Summer\artegame\src\scenes\defeat\ui\index.py", "Python", 105, 0, 0, 0, 9, 13, 127
"d:\_code\python\24 - Summer\artegame\src\scenes\game\routines\conf.py", "Python", 298, 0, 0, 0, 109, 13, 420
"d:\_code\python\24 - Summer\artegame\src\scenes\game\routines\main.py", "Python", 24, 0, 0, 0, 7, 7, 38
"d:\_code\python\24 - Summer\artegame\src\scenes\game\routines\player.py", "Python", 472, 0, 0, 0, 51, 129, 652
"d:\_code\python\24 - Summer\artegame\src\scenes\game\ui\index.py", "Python", 502, 0, 0, 0, 28, 14, 544
"Total", "-", 6346, 23, 1, 29, 668, 1851, 8918