"filename", "language", "Markdown", "Python", "Batch", "comment", "blank", "total"
"d:\_code\py\artegame\README.md", "Markdown", 23, 0, 0, 0, 14, 37
"d:\_code\py\artegame\architect.bat", "Batch", 0, 0, 1, 0, 0, 1
"d:\_code\py\artegame\architect\__config__.py", "Python", 0, 29, 0, 6, 10, 45
"d:\_code\py\artegame\architect\__main__.py", "Python", 0, 19, 0, 2, 8, 29
"d:\_code\py\artegame\architect\b64encoder.py", "Python", 0, 36, 0, 3, 14, 53
"d:\_code\py\artegame\architect\cli.py", "Python", 0, 161, 0, 20, 59, 240
"d:\_code\py\artegame\architect\deps.py", "Python", 0, 124, 0, 10, 48, 182
"d:\_code\py\artegame\architect\import_generator.py", "Python", 0, 228, 0, 8, 68, 304
"d:\_code\py\artegame\brass\__main__.py", "Python", 0, 68, 0, 14, 25, 107
"d:\_code\py\artegame\brass\animator\__init__.py", "Python", 0, 136, 0, 48, 64, 248
"d:\_code\py\artegame\brass\animator\interpolation.py", "Python", 0, 51, 0, 2, 15, 68
"d:\_code\py\artegame\brass\animator\play_objects.py", "Python", 0, 25, 0, 0, 13, 38
"d:\_code\py\artegame\brass\animator\store.py", "Python", 0, 11, 0, 0, 7, 18
"d:\_code\py\artegame\brass\assets.py", "Python", 0, 49, 0, 4, 21, 74
"d:\_code\py\artegame\brass\audio.py", "Python", 0, 41, 0, 1, 27, 69
"d:\_code\py\artegame\brass\base.py", "Python", 0, 117, 0, 1, 54, 172
"d:\_code\py\artegame\brass\collision.py", "Python", 0, 128, 0, 3, 33, 164
"d:\_code\py\artegame\brass\display.py", "Python", 0, 240, 0, 33, 70, 343
"d:\_code\py\artegame\brass\enums\__init__.py", "Python", 0, 8, 0, 1, 1, 10
"d:\_code\py\artegame\brass\enums\animations.py", "Python", 0, 9, 0, 0, 5, 14
"d:\_code\py\artegame\brass\enums\gui.py", "Python", 0, 29, 0, 0, 8, 37
"d:\_code\py\artegame\brass\enums\input_modes.py", "Python", 0, 2, 0, 0, 2, 4
"d:\_code\py\artegame\brass\enums\keybinds.py", "Python", 0, 12, 0, 0, 6, 18
"d:\_code\py\artegame\brass\enums\scenes.py", "Python", 0, 3, 0, 1, 2, 6
"d:\_code\py\artegame\brass\enums\spells.py", "Python", 0, 37, 0, 0, 4, 41
"d:\_code\py\artegame\brass\events.py", "Python", 0, 30, 0, 0, 20, 50
"d:\_code\py\artegame\brass\gui.py", "Python", 0, 254, 0, 8, 68, 330
"d:\_code\py\artegame\brass\inpt.py", "Python", 0, 295, 0, 16, 99, 410
"d:\_code\py\artegame\brass\items.py", "Python", 0, 80, 0, 11, 40, 131
"d:\_code\py\artegame\brass\pgapi.py", "Python", 0, 84, 0, 0, 51, 135
"d:\_code\py\artegame\brass\saves.py", "Python", 0, 83, 0, 11, 39, 133
"d:\_code\py\artegame\brass\scene.py", "Python", 0, 45, 0, 6, 31, 82
"d:\_code\py\artegame\brass\structures.py", "Python", 0, 330, 0, 30, 112, 472
"d:\_code\py\artegame\brass\timeout.py", "Python", 0, 14, 0, 0, 8, 22
"d:\_code\py\artegame\brass\vectormath.py", "Python", 0, 214, 0, 4, 71, 289
"d:\_code\py\artegame\src\global_routines\boons.py", "Python", 0, 800, 0, 106, 205, 1111
"d:\_code\py\artegame\src\global_routines\crowd_control.py", "Python", 0, 70, 0, 3, 20, 93
"d:\_code\py\artegame\src\global_routines\dash.py", "Python", 0, 32, 0, 2, 14, 48
"d:\_code\py\artegame\src\global_routines\effect_display.py", "Python", 0, 30, 0, 3, 13, 46
"d:\_code\py\artegame\src\global_routines\enemies.py", "Python", 0, 216, 0, 10, 47, 273
"d:\_code\py\artegame\src\global_routines\interact.py", "Python", 0, 42, 0, 0, 26, 68
"d:\_code\py\artegame\src\global_routines\menus.py", "Python", 0, 58, 0, 2, 27, 87
"d:\_code\py\artegame\src\global_routines\projectiles.py", "Python", 0, 163, 0, 10, 27, 200
"d:\_code\py\artegame\src\global_routines\round_manager.py", "Python", 0, 109, 0, 2, 28, 139
"d:\_code\py\artegame\src\global_routines\sounds.py", "Python", 0, 40, 0, 0, 22, 62
"d:\_code\py\artegame\src\global_routines\spells.py", "Python", 0, 126, 0, 1, 45, 172
"d:\_code\py\artegame\src\scenes\default\routines\conf.py", "Python", 0, 9, 0, 5, 4, 18
"d:\_code\py\artegame\src\scenes\default\routines\main.py", "Python", 0, 13, 0, 6, 6, 25
"d:\_code\py\artegame\src\scenes\default\ui\index.py", "Python", 0, 91, 0, 11, 14, 116
"d:\_code\py\artegame\src\scenes\defeat\routines\conf.py", "Python", 0, 9, 0, 5, 4, 18
"d:\_code\py\artegame\src\scenes\defeat\routines\main.py", "Python", 0, 13, 0, 6, 6, 25
"d:\_code\py\artegame\src\scenes\defeat\ui\index.py", "Python", 0, 105, 0, 9, 13, 127
"d:\_code\py\artegame\src\scenes\game\routines\conf.py", "Python", 0, 297, 0, 109, 13, 419
"d:\_code\py\artegame\src\scenes\game\routines\main.py", "Python", 0, 23, 0, 7, 7, 37
"d:\_code\py\artegame\src\scenes\game\routines\player.py", "Python", 0, 471, 0, 51, 129, 651
"d:\_code\py\artegame\src\scenes\game\ui\index.py", "Python", 0, 502, 0, 28, 14, 544
"Total", "-", 23, 6211, 1, 619, 1801, 8655